50 50
FFFFFFFFFFFFFFFFFFFFFFFFFFFFFFFFFFFFFFFFFFFFFFFFFF
FFFFFFFFFFFFFFFFFFFFFFFFFFFFFFFFFFFFFFFFFFFFFFFFFF
FFFFFFFFFFFFFFFFFFFFFFFFFFFFFFFFFFFFFFFFFFFFFFFFFF
FFFWWWWWFFFFFFFFFFFFFFFFFFFFFFFFFFFFFFFFFFWWWWWFFF
FFFWFFFFFFFFFFFFFFFFFFFFFFFFFFFFFFFFFFFFFFFFFFWFFF
FFFWFFFFFFFFFFFFFFFFFFFFFFFFFFFFFFFFFFFFFSFFFFWFFF
FFFWFFFFFFFFFFFFFFFFFFFFFFFFFFFFFFFFFFFFFFFFFFWFFF
FFFWFFFFFFFFFFFFFFFFWWWWWWWWWWFFFFFFFFFFFFFFFFWFFF
FFFFFFFFFFFFFFFFFFFFFFFFFFFFFFFFFFFFFFFFFFFFFFFFFF
FFFFFFFFFFFFFFFFFFFFFFFFFFFFFFFFFFFFFFFFFFFFFFFFFF
FFFFFFFFFFFFFFFFFFFFFFFFFFFFFFFFFFFFFFFFFFFFFFFFFF
FFFFFFFFFFFFFWFFFFFFFFFFFFFFFFFFFFFFWFFFFFFFFFFFFF
FFFFFFFFFFFFFWFFFFFFFFFFFFFFFFFFFFFFWFFFFFFFFFFFFF
FFFFFFFFWWWWWWFFFFFFFFFFFFFFFFFFFFFFWWWWWWFFFFFFFF
FFFFFFFFFFFFFWFFFFFFFFFFFFFFFFFFFFFFWFFFFFFFFFFFFF
FFFFFFFFFFFFFWFFFFFFFFFFFFFFFFFFFFFFWFFFFFFFFFFFFF
FFFFFFFFFFFFFFFFFFFFFFFFFFFFFFFFFFFFFFFFFFFFFFFFFF
FFFFFFFFFFFFFFFFFFFFFFFFFFFFFFFFFFFFFFFFFFFFFFFFFF
FFFFFFFFFFFFFFFFFFFFFFFFFFFFFFFFFFFFFFFFFFFFFFFFFF
FFFFFFFFFFFFFFFFFFFFFFFFFFFFFFFFFFFFFFFFFFFFFFFFFF
FFFFFFFFFFWWWWWWWFFFFFFFFFFFFFFFFWWWWWWWFFFFFFFFFF
FFFFFFFFFFFFFFFFFFFFFFFFFFFFFFFFFFFFFFFFFFFFFFFFFF
FFFFFFFFFFFFFFFFFFFFFFFFFFFFFFFFFFFFFFFFFFFFFFFFFF
FFFFFFFFFFFFFFFFFFFFFFFFFFFFFFFFFFFFFFFFFFFFFFFFFF
FFFFFFFFFFFFFFFFFFFFFFFFWWFFFFFFFFFFFFFFFFFFFFFFFF
FFFFFFFFFFFFFFFFFFFFFFFFWWFFFFFFFFFFFFFFFFFFFFFFFF
FFFFFFFFFFFFFFFFFFFFFFFFFFFFFFFFFFFFFFFFFFFFFFFFFF
FFFFFFFFFFFFFFFFFFFFFFFFFFFFFFFFFFFFFFFFFFFFFFFFFF
FFFFFFFFFFFFFFFFFFFFFFFFFFFFFFFFFFFFFFFFFFFFFFFFFF
FFFFFFFFFFWWWWWWWFFFFFFFFFFFFFFFFWWWWWWWFFFFFFFFFF
FFFFFFFFFFFFFFFFFFFFFFFFFFFFFFFFFFFFFFFFFFFFFFFFFF
FFFFFFFFFFFFFFFFFFFFFFFFFFFFFFFFFFFFFFFFFFFFFFFFFF
FFFFFFFFFFFFFFFFFFFFFFFFFFFFFFFFFFFFFFFFFFFFFFFFFF
FFFFFFFFFFFFFFFFFFFFFFFFFFFFFFFFFFFFFFFFFFFFFFFFFF
FFFFFFFFFFFFFWFFFFFFFFFFFFFFFFFFFFFFWFFFFFFFFFFFFF
FFFFFFFFFFFFFWFFFFFFFFFFFFFFFFFFFFFFWFFFFFFFFFFFFF
FFFFFFFFWWWWWWFFFFFFFFFFFFFFFFFFFFFFWWWWWWFFFFFFFF
FFFFFFFFFFFFFWFFFFFFFFFFFFFFFFFFFFFFWFFFFFFFFFFFFF
FFFFFFFFFFFFFWFFFFFFFFFFFFFFFFFFFFFFWFFFFFFFFFFFFF
FFFFFFFFFFFFFFFFFFFFFFFFFFFFFFFFFFFFFFFFFFFFFFFFFF
FFFFFFFFFFFFFFFFFFFFFFFFFFFFFFFFFFFFFFFFFFFFFFFFFF
FFFFFFFFFFFFFFFFFFFFFFFFFFFFFFFFFFFFFFFFFFFFFFFFFF
FFFWFFFFFFFFFFFFFFFFWWWWWWWWWWFFFFFFFFFFFFFFFFWFFF
FFFWFFFFFFFFFFFFFFFFFFFFFFFFFFFFFFFFFFFFFFFFFFWFFF
FFFWFFFFPFFFFFFFFFFFFFFFFFFFFFFFFFFFFFFFFFFFFFWFFF
FFFWFFFFFFFFFFFFFFFFFFFFFFFFFFFFFFFFFFFFFFFFFFWFFF
FFFWWWWWFFFFFFFFFFFFFFFFFFFFFFFFFFFFFFFFFFWWWWWFFF
FFFFFFFFFFFFFFFFFFFFFFFFFFFFFFFFFFFFFFFFFFFFFFFFFF
FFFFFFFFFFFFFFFFFFFFFFFFFFFFFFFFFFFFFFFFFFFFFFFFFF
FFFFFFFFFFFFFFFFFFFFFFFFFFFFFFFFFFFFFFFFFFFFFFFFFF